"Cloudlet ID","Status","Data center ID","VM ID","Time","Start Time","Finish Time","Waiting","Completion","RAM Utilization1","RAM Utilization2","RAM Utilization3","RAM Utilization4","RAM Utilization5","RAM Utilization6"
"01","SUCCESS","09","09","241","11","252","00","241","01","01","01","01","01","01"
"02","SUCCESS","06","06","528","11","539","00","528","01","01","01","01","01","01"
"03","SUCCESS","11","11","535","11","546","00","535","01","01","01","01","01","01"
"00","SUCCESS","03","03","677","11","688","00","677","01","01","01","01","01","01"
"04","SUCCESS","06","06","169","539","708","528","697","01","01","01","01","01","01"
"06","SUCCESS","04","04","1025","11","1036","00","1025","01","01","01","01","01","01"
"07","SUCCESS","03","03","416","688","1104","677","1093","01","01","01","01","01","01"
"05","SUCCESS","11","11","606","546","1152","535","1141","01","01","01","01","01","01"
"08","SUCCESS","06","06","567","708","1275","697","1264","01","01","01","01","01","01"
"09","SUCCESS","03","03","568","1104","1672","1093","1661","01","01","01","01","01","01"
"Makespan using QLearning:","2556.3724531155585"
"Total Completion Time:","8862.0"
"Avg Completion Time:","886.2"
"Total Cost:","10664.0"
"Avg Cost:","1066.4"
"Avg Waiting Time:","353.0"
"Successful Rate:","1.0"
"Avg CPU Utilization:","2.4685185185185183"
"Total Power:","623259.0"
"Average Ram:","1.0"
