"Cloudlet ID","Status","Data center ID","VM ID","Time","Start Time","Finish Time","Waiting","Completion","RAM Utilization1","RAM Utilization2","RAM Utilization3","RAM Utilization4","RAM Utilization5","RAM Utilization6"
"01","SUCCESS","05","05","336","11","347","00","336","01","01","01","01","01","01"
"00","SUCCESS","03","03","635","11","646","00","635","01","01","01","01","01","01"
"07","SUCCESS","10","10","730","11","741","00","730","01","01","01","01","01","01"
"02","SUCCESS","08","08","758","11","769","00","758","01","01","01","01","01","01"
"03","SUCCESS","04","04","888","11","899","00","888","01","01","01","01","01","01"
"06","SUCCESS","03","03","886","646","1532","635","1521","01","01","01","01","01","01"
"04","SUCCESS","08","08","874","769","1643","758","1632","01","01","01","01","01","01"
"05","SUCCESS","04","04","870","899","1769","888","1758","01","01","01","01","01","01"
"09","SUCCESS","08","08","515","1643","2158","1632","2147","01","01","01","01","01","01"
"08","Failure","04","04","611","1769","2380","1758","2369","01","01","01","01","01","01"
"Makespan using QLearning:","1393.97808381463"
"Total Completion Time:","12774.0"
"Avg Completion Time:","1277.4"
"Total Cost:","14206.0"
"Avg Cost:","1420.6"
"Avg Waiting Time:","567.1"
"Successful Rate:","0.9"
"Avg CPU Utilization:","Infinity"
"Total Power:","830466.0"
"Average Ram:","1.0"
